5555555555
5555555555
4444444444
4444444444
3333333333
3333333333
2222222222
2222222222
0000000000
0000000000
0000000000
0000000000
0000000000